2
01 01 01 01 01 01 01 01 01 01 01 01 01 01 01 01 01 01 01 01 01 01 01 01 01 01 01 01 01 01
01 00 00 00 00 00 00 00 00 00 00 00 00 00 00 00 00 00 00 00 00 00 00 00 00 00 00 00 00 01
01 00 01 01 01 01 01 01 01 01 01 01 01 01 01 01 01 01 01 01 01 01 01 01 01 01 01 01 00 01
01 00 01 00 00 00 00 00 00 00 00 00 00 00 00 00 00 00 00 00 00 00 00 00 00 00 01 01 00 01
01 00 01 00 02 02 02 01 01 01 01 01 01 01 01 01 01 01 01 01 01 01 01 01 01 00 01 01 00 01
01 00 01 00 02 02 02 00 00 00 00 00 00 00 00 00 00 00 00 00 00 00 00 00 01 00 01 01 00 01
01 00 01 00 02 02 02 01 01 01 01 01 01 01 01 01 01 01 01 01 01 01 01 01 01 00 01 01 00 01
01 00 01 00 00 00 00 00 00 00 00 00 00 00 00 00 00 00 00 00 00 00 00 00 00 00 01 01 00 01
01 00 01 01 01 01 01 01 01 01 01 01 01 01 01 01 01 01 01 01 01 01 01 01 01 01 01 01 00 01
01 00 00 00 00 00 00 00 00 00 00 00 00 00 00 00 00 00 00 00 00 00 00 00 00 00 00 00 00 01
01 01 01 01 01 01 01 01 01 01 01 01 01 01 01 01 01 01 01 01 01 01 01 01 01 01 01 01 01 01
01 00 00 00 00 00 00 00 00 00 00 00 00 00 01 01 00 00 00 00 00 00 00 00 00 00 00 00 00 01
01 00 01 01 01 01 01 01 01 01 01 01 01 01 00 00 01 01 01 01 01 01 01 01 01 01 01 01 00 01
01 00 00 00 00 00 00 00 00 00 00 00 00 02 00 00 02 00 00 00 00 00 00 00 00 00 00 00 00 01
01 01 01 01 01 01 01 01 01 01 01 01 01 02 00 00 02 01 01 01 01 01 01 01 01 01 01 01 01 01


air	brick	stone	
00	01	02		